
SO ./map/texture/lee_south.xpm


C       200,244,255
EA                ./map/texture/gun_east.xpm

F      168,153,198
WE                                ./map/texture/gon_west.xpm


      NO       ./map/texture/gam_north.xpm


            11111111111111111111
111111111111111000011100111000011111111111111111
            10000011100111000011111111
             1100001110011100001111111
1111   111111110000111001110000111111111111
11     111111110000010000000E00011111
1             10000111001110000111
       11111111000011100111000011
111    1111111100001110011100001
            11100001110011100001
               1111   11   1111
111
11